WE ./textures/specchio.xpm
NO ./textures/no_exit.xpm

SO ./textures/texture.xpm

EA ./textures/texture4.xpm
F 220, 100,0
C 225,30,0


1111111111111111111111111111111111111111111111111111111
1000000000000000000000000000000000000000000000000000001
1000000000001000000010000000000000000000000000000000001
1000000000001000000001000000000000000000000001000000001
1000000001111000000000100000000000000000000001000000001
10E0000000000000000000010000000000000000000001011111111
1111111111111111111111111111111111111111111111111111111
