WE ./textures/panel1.xpm
NO ./textures/green_stone.xpm

SO ./textures/64/sud.xpm

EA ./textures/64/EW.xpm
F ./textures/10-1.xpm
C ./textures/tetto.xpm
D  ./textures/Porta_chiusa.xpm


1111111111111111111111111111111111111111111111111111111111111111
1000000000000000000000000000000000000000000000000000000000000001
1000000000000000000000000000000000000000000000000000000000000001
1000000000000000000000000000000000000000000000000000000000000001
1111111111111111111111111111111111111111111111100000000000000001
1111111111111111111111111111111111111111111000000000000000000001
1111111111111111111111110040040000404000442400000000000000W00001
1111111111111111111111111111111111111111111000000000000000000001
1111111111111111111111111111111111111111111111100000000000000001
1111111111111111111111111111110000000000000000000000000000000001
1111111111111111111111111000000000000000000000000000011111111111
1111111111111111111100000000000000000000000000001111111111111111
1111111111111111111100000000000000000000000011111111111111111111
1111111111111111000000000000000000000011111111111111111111111111
1111111111110000000000000000001111111111111111111111111111111111
1111111100000000000000000111111111111111111111111111111111111111
1111111100000000000000000000000000000000000000000000000000000001
1111111100000000000000000000000000000000000000000000000000000001
1111111100000000000000000000000000000000000000000000000000000001
1111111111111111111111111111111111111111111111111111111111111111