WE ./textures/panel1.xpm
NO ./textures/green_stone.xpm

SO ./textures/64/sud.xpm

EA ./textures/64/EW.xpm
F ./textures/10-1.xpm
C ./textures/tetto.xpm
D  ./textures/Porta_chiusa.xpm


111118888888888888888888888888888888888888888888888888888888
1E0090000000000000000000000000000000000000000000000000000008
111118888888888888888888888888888888888888888888888888888888