WE ./textures/panel1.xpm
NO ./textures/green_stone.xpm

SO ./textures/64/sud.xpm

EA ./textures/64/EW.xpm
F ./textures/10-1.xpm
C ./textures/tetto.xpm
D  ./textures/Porta_chiusa.xpm
11111111111111111111111111
140000000W0110004000050001
10210000011150000000000001
10015000000000000000000501
111111111011000001110000011111111
100000000011000001110111111111111
11110111111111011100000010001
11110111111111011102020010001
11000000110101011100000010001
14000000000000001100400010001
10000000000000001102020010001
1100000111010101112101111000111
11110111 1110101 101111010001
11111111 1111111 111111111111
